d	あ
h	い
t	う
n	え
s	お
b	あん
m	いん
w	うん
v	えん
z	おん
f	あっ
g	いっ
c	うっ
r	えっ
l	おっ
ud	か
uh	き
ut	く
un	け
us	こ
ub	かん
um	きん
uw	くん
uv	けん
uz	こん
uf	かっ
ug	きっ
uc	くっ
ur	けっ
ul	こっ
kd	が
kh	ぎ
kt	ぐ
kn	げ
ks	ご
kb	がん
km	ぎん
kw	ぐん
kv	げん
kz	ごん
kf	がっ
kg	ぎっ
kc	ぐっ
kr	げっ
kl	ごっ
ed	さ
eh	し
et	す
en	せ
es	そ
eb	さん
em	しん
ew	すん
ev	せん
ez	そん
ef	さっ
eg	しっ
ec	すっ
er	せっ
el	そっ
jd	ざ
jh	じ
jt	ず
jn	ぜ
js	ぞ
jb	ざん
jm	じん
jw	ずん
jv	ぜん
jz	ぞん
jf	ざっ
jg	じっ
jc	ずっ
jr	ぜっ
jl	ぞっ
od	た
oh	ち
ot	つ
on	て
os	と
ob	たん
om	ちん
ow	つん
ov	てん
oz	とん
of	たっ
og	ちっ
oc	つっ
or	てっ
ol	とっ
qd	だ
qh	ぢ
qt	づ
qn	で
qs	ど
qb	だん
qm	ぢん
qw	づん
qv	でん
qz	どん
qf	だっ
qg	ぢっ
qc	づっ
qr	でっ
ql	どっ
ad	な
ah	に
at	ぬ
an	ね
as	の
ab	なん
am	にん
aw	ぬん
av	ねん
az	のん
af	なっ
ag	にっ
ac	ぬっ
ar	ねっ
al	のっ
id	は
ih	ひ
it	ふ
in	へ
is	ほ
ib	はん
im	ひん
iw	ふん
iv	へん
iz	ほん
if	はっ
ig	ひっ
ic	ふっ
ir	へっ
il	ほっ
xd	ば
xh	び
xt	ぶ
xn	べ
xs	ぼ
xb	ばん
xm	びん
xw	ぶん
xv	べん
xz	ぼん
xf	ばっ
xg	びっ
xc	ぶっ
xr	べっ
xl	ぼっ
yd	ぱ
yh	ぴ
yt	ぷ
yn	ぺ
ys	ぽ
yb	ぱん
ym	ぴん
yw	ぷん
yv	ぺん
yz	ぽん
yf	ぱっ
yg	ぴっ
yc	ぷっ
yr	ぺっ
yl	ぽっ
pd	ま
ph	み
pt	む
pn	め
ps	も
pb	まん
pm	みん
pw	むん
pv	めん
pz	もん
pf	まっ
pg	みっ
pc	むっ
pr	めっ
pl	もっ
.d	や
.h	い
.t	ゆ
.n	え
.s	よ
.b	やん
.m	いん
.w	ゆん
.v	えん
.z	よん
.f	やっ
.g	いっ
.c	ゆっ
.r	えっ
.l	よっ
,d	ら
,h	り
,t	る
,n	れ
,s	ろ
,b	らん
,m	りん
,w	るん
,v	れん
,z	ろん
,f	らっ
,g	りっ
,c	るっ
,r	れっ
,l	ろっ
'd	わ
'h	ゐ
't	う
'n	ゑ
's	を
'b	わん
'm	ゐん
'w	うん
'v	ゑん
'z	をん
'f	わっ
'g	ゐっ
'c	うっ
'r	ゑっ
'l	をっ
F	ああ
G	あい
C	あう
R	あえ
L	あお
uF	かあ
uG	かい
uC	かう
uR	かえ
uL	かお
kF	があ
kG	がい
kC	がう
kR	がえ
kL	がお
eF	さあ
eG	さい
eC	さう
eR	さえ
eL	さお
jF	ざあ
jG	ざい
jC	ざう
jR	ざえ
jL	ざお
oF	たあ
oG	たい
oC	たう
oR	たえ
oL	たお
qF	だあ
qG	だい
qC	だう
qR	だえ
qL	だお
aF	なあ
aG	ない
aC	なう
aR	なえ
aL	なお
iF	はあ
iG	はい
iC	はう
iR	はえ
iL	はお
xF	ばあ
xG	ばい
xC	ばう
xR	ばえ
xL	ばお
yF	ぱあ
yG	ぱい
yC	ぱう
yR	ぱえ
yL	ぱお
pF	まあ
pG	まい
pC	まう
pR	まえ
pL	まお
.F	やあ
.G	やい
.C	やう
.R	やえ
.L	やお
,F	らあ
,G	らい
,C	らう
,R	らえ
,L	らお
'F	わあ
'G	わい
'C	わう
'R	わえ
'L	わお
D	うあ
H	うい
T	うう
N	うえ
S	うお
uD	くあ
uH	くい
uT	くう
uN	くえ
uS	くお
kD	ぐあ
kH	ぐい
kT	ぐう
kN	ぐえ
kS	ぐお
eD	すあ
eH	すい
eT	すう
eN	すえ
eS	すお
jD	ずあ
jH	ずい
jT	ずう
jN	ずえ
jS	ずお
oD	つあ
oH	つい
oT	つう
oN	つえ
oS	つお
qD	づあ
qH	づい
qT	づう
qN	づえ
qS	づお
aD	ぬあ
aH	ぬい
aT	ぬう
aN	ぬえ
aS	ぬお
iD	ふあ
iH	ふい
iT	ふう
iN	ふえ
iS	ふお
xD	ぶあ
xH	ぶい
xT	ぶう
xN	ぶえ
xS	ぶお
yD	ぷあ
yH	ぷい
yT	ぷう
yN	ぷえ
yS	ぷお
pD	むあ
pH	むい
pT	むう
pN	むえ
pS	むお
.D	ゆあ
.H	ゆい
.T	ゆう
.N	ゆえ
.S	ゆお
,D	るあ
,H	るい
,T	るう
,N	るえ
,S	るお
'D	うあ
'H	うい
'T	うう
'N	うえ
'S	うお
B	おあ
M	おい
W	おう
V	おえ
Z	おお
uB	こあ
uM	こい
uW	こう
uV	こえ
uZ	こお
kB	ごあ
kM	ごい
kW	ごう
kV	ごえ
kZ	ごお
eB	そあ
eM	そい
eW	そう
eV	そえ
eZ	そお
jB	ぞあ
jM	ぞい
jW	ぞう
jV	ぞえ
jZ	ぞお
oB	とあ
oM	とい
oW	とう
oV	とえ
oZ	とお
qB	どあ
qM	どい
qW	どう
qV	どえ
qZ	どお
aB	のあ
aM	のい
aW	のう
aV	のえ
aZ	のお
iB	ほあ
iM	ほい
iW	ほう
iV	ほえ
iZ	ほお
xB	ぼあ
xM	ぼい
xW	ぼう
xV	ぼえ
xZ	ぼお
yB	ぽあ
yM	ぽい
yW	ぽう
yV	ぽえ
yZ	ぽお
pB	もあ
pM	もい
pW	もう
pV	もえ
pZ	もお
.B	よあ
.M	よい
.W	よう
.V	よえ
.Z	よお
,B	ろあ
,M	ろい
,W	ろう
,V	ろえ
,Z	ろお
'B	をあ
'M	をい
'W	をう
'V	をえ
'Z	をお
uid	かあ
uih	かい
uit	かう
uin	かえ
uis	かお
uib	かあん
uim	かいん
uiw	かうん
uiv	かえん
uiz	かおん
uif	かあっ
uig	かいっ
uic	かうっ
uir	かえっ
uil	かおっ
kxd	があ
kxh	がい
kxt	がう
kxn	がえ
kxs	がお
kxb	があん
kxm	がいん
kxw	がうん
kxv	がえん
kxz	がおん
kxf	があっ
kxg	がいっ
kxc	がうっ
kxr	がえっ
kxl	がおっ
eid	さあ
eih	さい
eit	さう
ein	さえ
eis	さお
eib	さあん
eim	さいん
eiw	さうん
eiv	さえん
eiz	さおん
eif	さあっ
eig	さいっ
eic	さうっ
eir	さえっ
eil	さおっ
jxd	ざあ
jxh	ざい
jxt	ざう
jxn	ざえ
jxs	ざお
jxb	ざあん
jxm	ざいん
jxw	ざうん
jxv	ざえん
jxz	ざおん
jxf	ざあっ
jxg	ざいっ
jxc	ざうっ
jxr	ざえっ
jxl	ざおっ
oid	たあ
oih	たい
oit	たう
oin	たえ
ois	たお
oib	たあん
oim	たいん
oiw	たうん
oiv	たえん
oiz	たおん
oif	たあっ
oig	たいっ
oic	たうっ
oir	たえっ
oil	たおっ
qxd	だあ
qxh	だい
qxt	だう
qxn	だえ
qxs	だお
qxb	だあん
qxm	だいん
qxw	だうん
qxv	だえん
qxz	だおん
qxf	だあっ
qxg	だいっ
qxc	だうっ
qxr	だえっ
qxl	だおっ
aid	なあ
aih	ない
ait	なう
ain	なえ
ais	なお
aib	なあん
aim	ないん
aiw	なうん
aiv	なえん
aiz	なおん
aif	なあっ
aig	ないっ
aic	なうっ
air	なえっ
ail	なおっ
iid	はあ
iih	はい
iit	はう
iin	はえ
iis	はお
iib	はあん
iim	はいん
iiw	はうん
iiv	はえん
iiz	はおん
iif	はあっ
iig	はいっ
iic	はうっ
iir	はえっ
iil	はおっ
xxd	ばあ
xxh	ばい
xxt	ばう
xxn	ばえ
xxs	ばお
xxb	ばあん
xxm	ばいん
xxw	ばうん
xxv	ばえん
xxz	ばおん
xxf	ばあっ
xxg	ばいっ
xxc	ばうっ
xxr	ばえっ
xxl	ばおっ
yyd	ぱあ
yyh	ぱい
yyt	ぱう
yyn	ぱえ
yys	ぱお
yyb	ぱあん
yym	ぱいん
yyw	ぱうん
yyv	ぱえん
yyz	ぱおん
yyf	ぱあっ
yyg	ぱいっ
yyc	ぱうっ
yyr	ぱえっ
yyl	ぱおっ
pyd	まあ
pyh	まい
pyt	まう
pyn	まえ
pys	まお
pyb	まあん
pym	まいん
pyw	まうん
pyv	まえん
pyz	まおん
pyf	まあっ
pyg	まいっ
pyc	まうっ
pyr	まえっ
pyl	まおっ
.yd	やあ
.yh	やい
.yt	やう
.yn	やえ
.ys	やお
.yb	やあん
.ym	やいん
.yw	やうん
.yv	やえん
.yz	やおん
.yf	やあっ
.yg	やいっ
.yc	やうっ
.yr	やえっ
.yl	やおっ
,yd	らあ
,yh	らい
,yt	らう
,yn	らえ
,ys	らお
,yb	らあん
,ym	らいん
,yw	らうん
,yv	らえん
,yz	らおん
,yf	らあっ
,yg	らいっ
,yc	らうっ
,yr	らえっ
,yl	らおっ
'yd	わあ
'yh	わい
'yt	わう
'yn	わえ
'ys	わお
'yb	わあん
'ym	わいん
'yw	わうん
'yv	わえん
'yz	わおん
'yf	わあっ
'yg	わいっ
'yc	わうっ
'yr	わえっ
'yl	わおっ
uiD	かぁ
uiH	かぃ
uiT	かぅ
uiN	かぇ
uiS	かぉ
uiB	かぁん
uiM	かぃん
uiW	かぅん
uiV	かぇん
uiZ	かぉん
uiF	かぁっ
uiG	かぃっ
uiC	かぅっ
uiR	かぇっ
uiL	かぉっ
kxD	がぁ
kxH	がぃ
kxT	がぅ
kxN	がぇ
kxS	がぉ
kxB	がぁん
kxM	がぃん
kxW	がぅん
kxV	がぇん
kxZ	がぉん
kxF	がぁっ
kxG	がぃっ
kxC	がぅっ
kxR	がぇっ
kxL	がぉっ
eiD	さぁ
eiH	さぃ
eiT	さぅ
eiN	さぇ
eiS	さぉ
eiB	さぁん
eiM	さぃん
eiW	さぅん
eiV	さぇん
eiZ	さぉん
eiF	さぁっ
eiG	さぃっ
eiC	さぅっ
eiR	さぇっ
eiL	さぉっ
jxD	ざぁ
jxH	ざぃ
jxT	ざぅ
jxN	ざぇ
jxS	ざぉ
jxB	ざぁん
jxM	ざぃん
jxW	ざぅん
jxV	ざぇん
jxZ	ざぉん
jxF	ざぁっ
jxG	ざぃっ
jxC	ざぅっ
jxR	ざぇっ
jxL	ざぉっ
oiD	たぁ
oiH	たぃ
oiT	たぅ
oiN	たぇ
oiS	たぉ
oiB	たぁん
oiM	たぃん
oiW	たぅん
oiV	たぇん
oiZ	たぉん
oiF	たぁっ
oiG	たぃっ
oiC	たぅっ
oiR	たぇっ
oiL	たぉっ
qxD	だぁ
qxH	だぃ
qxT	だぅ
qxN	だぇ
qxS	だぉ
qxB	だぁん
qxM	だぃん
qxW	だぅん
qxV	だぇん
qxZ	だぉん
qxF	だぁっ
qxG	だぃっ
qxC	だぅっ
qxR	だぇっ
qxL	だぉっ
aiD	なぁ
aiH	なぃ
aiT	なぅ
aiN	なぇ
aiS	なぉ
aiB	なぁん
aiM	なぃん
aiW	なぅん
aiV	なぇん
aiZ	なぉん
aiF	なぁっ
aiG	なぃっ
aiC	なぅっ
aiR	なぇっ
aiL	なぉっ
iiD	はぁ
iiH	はぃ
iiT	はぅ
iiN	はぇ
iiS	はぉ
iiB	はぁん
iiM	はぃん
iiW	はぅん
iiV	はぇん
iiZ	はぉん
iiF	はぁっ
iiG	はぃっ
iiC	はぅっ
iiR	はぇっ
iiL	はぉっ
xxD	ばぁ
xxH	ばぃ
xxT	ばぅ
xxN	ばぇ
xxS	ばぉ
xxB	ばぁん
xxM	ばぃん
xxW	ばぅん
xxV	ばぇん
xxZ	ばぉん
xxF	ばぁっ
xxG	ばぃっ
xxC	ばぅっ
xxR	ばぇっ
xxL	ばぉっ
yyD	ぱぁ
yyH	ぱぃ
yyT	ぱぅ
yyN	ぱぇ
yyS	ぱぉ
yyB	ぱぁん
yyM	ぱぃん
yyW	ぱぅん
yyV	ぱぇん
yyZ	ぱぉん
yyF	ぱぁっ
yyG	ぱぃっ
yyC	ぱぅっ
yyR	ぱぇっ
yyL	ぱぉっ
pyD	まぁ
pyH	まぃ
pyT	まぅ
pyN	まぇ
pyS	まぉ
pyB	まぁん
pyM	まぃん
pyW	まぅん
pyV	まぇん
pyZ	まぉん
pyF	まぁっ
pyG	まぃっ
pyC	まぅっ
pyR	まぇっ
pyL	まぉっ
.yD	やぁ
.yH	やぃ
.yT	やぅ
.yN	やぇ
.yS	やぉ
.yB	やぁん
.yM	やぃん
.yW	やぅん
.yV	やぇん
.yZ	やぉん
.yF	やぁっ
.yG	やぃっ
.yC	やぅっ
.yR	やぇっ
.yL	やぉっ
,yD	らぁ
,yH	らぃ
,yT	らぅ
,yN	らぇ
,yS	らぉ
,yB	らぁん
,yM	らぃん
,yW	らぅん
,yV	らぇん
,yZ	らぉん
,yF	らぁっ
,yG	らぃっ
,yC	らぅっ
,yR	らぇっ
,yL	らぉっ
'yD	わぁ
'yH	わぃ
'yT	わぅ
'yN	わぇ
'yS	わぉ
'yB	わぁん
'yM	わぃん
'yW	わぅん
'yV	わぇん
'yZ	わぉん
'yF	わぁっ
'yG	わぃっ
'yC	わぅっ
'yR	わぇっ
'yL	わぉっ
uud	きゃ
uuh	きぃ
uut	きゅ
uun	きぇ
uus	きょ
uub	きゃん
uum	きぃん
uuw	きゅん
uuv	きぇん
uuz	きょん
uuf	きゃっ
uug	きぃっ
uuc	きゅっ
uur	きぇっ
uul	きょっ
kkd	ぎゃ
kkh	ぎぃ
kkt	ぎゅ
kkn	ぎぇ
kks	ぎょ
kkb	ぎゃん
kkm	ぎぃん
kkw	ぎゅん
kkv	ぎぇん
kkz	ぎょん
kkf	ぎゃっ
kkg	ぎぃっ
kkc	ぎゅっ
kkr	ぎぇっ
kkl	ぎょっ
eud	しゃ
euh	しぃ
eut	しゅ
eun	しぇ
eus	しょ
eub	しゃん
eum	しぃん
euw	しゅん
euv	しぇん
euz	しょん
euf	しゃっ
eug	しぃっ
euc	しゅっ
eur	しぇっ
eul	しょっ
jkd	じゃ
jkh	じぃ
jkt	じゅ
jkn	じぇ
jks	じょ
jkb	じゃん
jkm	じぃん
jkw	じゅん
jkv	じぇん
jkz	じょん
jkf	じゃっ
jkg	じぃっ
jkc	じゅっ
jkr	じぇっ
jkl	じょっ
oud	ちゃ
ouh	ちぃ
out	ちゅ
oun	ちぇ
ous	ちょ
oub	ちゃん
oum	ちぃん
ouw	ちゅん
ouv	ちぇん
ouz	ちょん
ouf	ちゃっ
oug	ちぃっ
ouc	ちゅっ
our	ちぇっ
oul	ちょっ
qkd	ぢゃ
qkh	ぢぃ
qkt	ぢゅ
qkn	ぢぇ
qks	ぢょ
qkb	ぢゃん
qkm	ぢぃん
qkw	ぢゅん
qkv	ぢぇん
qkz	ぢょん
qkf	ぢゃっ
qkg	ぢぃっ
qkc	ぢゅっ
qkr	ぢぇっ
qkl	ぢょっ
aud	にゃ
auh	にぃ
aut	にゅ
aun	にぇ
aus	にょ
aub	にゃん
aum	にぃん
auw	にゅん
auv	にぇん
auz	にょん
auf	にゃっ
aug	にぃっ
auc	にゅっ
aur	にぇっ
aul	にょっ
iud	ひゃ
iuh	ひぃ
iut	ひゅ
iun	ひぇ
ius	ひょ
iub	ひゃん
ium	ひぃん
iuw	ひゅん
iuv	ひぇん
iuz	ひょん
iuf	ひゃっ
iug	ひぃっ
iuc	ひゅっ
iur	ひぇっ
iul	ひょっ
xkd	びゃ
xkh	びぃ
xkt	びゅ
xkn	びぇ
xks	びょ
xkb	びゃん
xkm	びぃん
xkw	びゅん
xkv	びぇん
xkz	びょん
xkf	びゃっ
xkg	びぃっ
xkc	びゅっ
xkr	びぇっ
xkl	びょっ
ypd	ぴゃ
yph	ぴぃ
ypt	ぴゅ
ypn	ぴぇ
yps	ぴょ
ypb	ぴゃん
ypm	ぴぃん
ypw	ぴゅん
ypv	ぴぇん
ypz	ぴょん
ypf	ぴゃっ
ypg	ぴぃっ
ypc	ぴゅっ
ypr	ぴぇっ
ypl	ぴょっ
ppd	みゃ
pph	みぃ
ppt	みゅ
ppn	みぇ
pps	みょ
ppb	みゃん
ppm	みぃん
ppw	みゅん
ppv	みぇん
ppz	みょん
ppf	みゃっ
ppg	みぃっ
ppc	みゅっ
ppr	みぇっ
ppl	みょっ
,pd	りゃ
,ph	りぃ
,pt	りゅ
,pn	れぇ
,ps	りょ
,pb	りゃん
,pm	りぃん
,pw	りゅん
,pv	れぇん
,pz	りょん
,pf	りゃっ
,pg	りぃっ
,pc	りゅっ
,pr	れぇっ
,pl	りょっ
;kd	ゔゃ
;kh	ゔぃ
;kt	ゔゅ
;kn	ゔぇ
;ks	ゔょ
;kb	ゔゃん
;km	ゔぃん
;kw	ゔゅん
;kv	ゔぇん
;kz	ゔょん
;kf	ゔゃっ
;kg	ゔぃっ
;kc	ゔゅっ
;kr	ゔぇっ
;kl	ゔょっ
uuF	きゃあ
uuG	きゃい
uuC	きゃう
uuR	きゃえ
uuL	きゃお
kkF	ぎゃあ
kkG	ぎゃい
kkC	ぎゃう
kkR	ぎゃえ
kkL	ぎゃお
euF	しゃあ
euG	しゃい
euC	しゃう
euR	しゃえ
euL	しゃお
jkF	じゃあ
jkG	じゃい
jkC	じゃう
jkR	じゃえ
jkL	じゃお
ouF	ちゃあ
ouG	ちゃい
ouC	ちゃう
ouR	ちゃえ
ouL	ちゃお
qkF	ぢゃあ
qkG	ぢゃい
qkC	ぢゃう
qkR	ぢゃえ
qkL	ぢゃお
auF	にゃあ
auG	にゃい
auC	にゃう
auR	にゃえ
auL	にゃお
iuF	ひゃあ
iuG	ひゃい
iuC	ひゃう
iuR	ひゃえ
iuL	ひゃお
xkF	びゃあ
xkG	びゃい
xkC	びゃう
xkR	びゃえ
xkL	びゃお
ypF	ぴゃあ
ypG	ぴゃい
ypC	ぴゃう
ypR	ぴゃえ
ypL	ぴゃお
ppF	みゃあ
ppG	みゃい
ppC	みゃう
ppR	みゃえ
ppL	みゃお
,pF	りゃあ
,pG	りゃい
,pC	りゃう
,pR	りゃえ
,pL	りゃお
;kF	ゔゃあ
;kG	ゔゃい
;kC	ゔゃう
;kR	ゔゃえ
;kL	ゔゃお
uuD	きゅあ
uuH	きゅい
uuT	きゅう
uuN	きゅえ
uuS	きゅお
kkD	ぎゅあ
kkH	ぎゅい
kkT	ぎゅう
kkN	ぎゅえ
kkS	ぎゅお
euD	しゅあ
euH	しゅい
euT	しゅう
euN	しゅえ
euS	しゅお
jkD	じゅあ
jkH	じゅい
jkT	じゅう
jkN	じゅえ
jkS	じゅお
ouD	ちゅあ
ouH	ちゅい
ouT	ちゅう
ouN	ちゅえ
ouS	ちゅお
qkD	ぢゅあ
qkH	ぢゅい
qkT	ぢゅう
qkN	ぢゅえ
qkS	ぢゅお
auD	にゅあ
auH	にゅい
auT	にゅう
auN	にゅえ
auS	にゅお
iuD	ひゅあ
iuH	ひゅい
iuT	ひゅう
iuN	ひゅえ
iuS	ひゅお
xkD	びゅあ
xkH	びゅい
xkT	びゅう
xkN	びゅえ
xkS	びゅお
ypD	ぴゅあ
ypH	ぴゅい
ypT	ぴゅう
ypN	ぴゅえ
ypS	ぴゅお
ppD	みゅあ
ppH	みゅい
ppT	みゅう
ppN	みゅえ
ppS	みゅお
,pD	りゅあ
,pH	りゅい
,pT	りゅう
,pN	りゅえ
,pS	りゅお
;kD	ゔゅあ
;kH	ゔゅい
;kT	ゔゅう
;kN	ゔゅえ
;kS	ゔゅお
uuB	きょあ
uuM	きょい
uuW	きょう
uuV	きょえ
uuZ	きょお
kkB	ぎょあ
kkM	ぎょい
kkW	ぎょう
kkV	ぎょえ
kkZ	ぎょお
euB	しょあ
euM	しょい
euW	しょう
euV	しょえ
euZ	しょお
jkB	じょあ
jkM	じょい
jkW	じょう
jkV	じょえ
jkZ	じょお
ouB	ちょあ
ouM	ちょい
ouW	ちょう
ouV	ちょえ
ouZ	ちょお
qkB	ぢょあ
qkM	ぢょい
qkW	ぢょう
qkV	ぢょえ
qkZ	ぢょお
auB	にょあ
auM	にょい
auW	にょう
auV	にょえ
auZ	にょお
iuB	ひょあ
iuM	ひょい
iuW	ひょう
iuV	ひょえ
iuZ	ひょお
xkB	びょあ
xkM	びょい
xkW	びょう
xkV	びょえ
xkZ	びょお
ypB	ぴょあ
ypM	ぴょい
ypW	ぴょう
ypV	ぴょえ
ypZ	ぴょお
ppB	みょあ
ppM	みょい
ppW	みょう
ppV	みょえ
ppZ	みょお
,pB	りょあ
,pM	りょい
,pW	りょう
,pV	りょえ
,pZ	りょお
;kB	ゔょあ
;kM	ゔょい
;kW	ゔょう
;kV	ゔょえ
;kZ	ゔょお
ued	くぁ
ueh	くぃ
uet	くぅ
uen	くぇ
ues	くぉ
ueb	くぁん
uem	くぃん
uew	くぅん
uev	くぇん
uez	くぉん
uef	くぁっ
ueg	くぃっ
uec	くぅっ
uer	くぇっ
uel	くぉっ
kjd	ぐぁ
kjh	ぐぃ
kjt	ぐぅ
kjn	ぐぇ
kjs	ぐぉ
kjb	ぐぁん
kjm	ぐぃん
kjw	ぐぅん
kjv	ぐぇん
kjz	ぐぉん
kjf	ぐぁっ
kjg	ぐぃっ
kjc	ぐぅっ
kjr	ぐぇっ
kjl	ぐぉっ
eed	すぁ
eeh	すぃ
eet	すぅ
een	すぇ
ees	すぉ
eeb	すぁん
eem	すぃん
eew	すぅん
eev	すぇん
eez	すぉん
eef	すぁっ
eeg	すぃっ
eec	すぅっ
eer	すぇっ
eel	すぉっ
jjd	ずぁ
jjh	ずぃ
jjt	ずぅ
jjn	ずぇ
jjs	ずぉ
jjb	ずぁん
jjm	ずぃん
jjw	ずぅん
jjv	ずぇん
jjz	ずぉん
jjf	ずぁっ
jjg	ずぃっ
jjc	ずぅっ
jjr	ずぇっ
jjl	ずぉっ
oed	つぁ
oeh	つぃ
oet	つぅ
oen	つぇ
oes	つぉ
oeb	つぁん
oem	つぃん
oew	つぅん
oev	つぇん
oez	つぉん
oef	つぁっ
oeg	つぃっ
oec	つぅっ
oer	つぇっ
oel	つぉっ
qjd	づぁ
qjh	づぃ
qjt	づぅ
qjn	づぇ
qjs	づぉ
qjb	づぁん
qjm	づぃん
qjw	づぅん
qjv	づぇん
qjz	づぉん
qjf	づぁっ
qjg	づぃっ
qjc	づぅっ
qjr	づぇっ
qjl	づぉっ
aed	ぬぁ
aeh	ぬぃ
aet	ぬぅ
aen	ぬぇ
aes	ぬぉ
aeb	ぬぁん
aem	ぬぃん
aew	ぬぅん
aev	ぬぇん
aez	ぬぉん
aef	ぬぁっ
aeg	ぬぃっ
aec	ぬぅっ
aer	ぬぇっ
ael	ぬぉっ
ied	ふぁ
ieh	ふぃ
iet	ふぅ
ien	ふぇ
ies	ふぉ
ieb	ふぁん
iem	ふぃん
iew	ふぅん
iev	ふぇん
iez	ふぉん
ief	ふぁっ
ieg	ふぃっ
iec	ふぅっ
ier	ふぇっ
iel	ふぉっ
xjd	ぶぁ
xjh	ぶぃ
xjt	ぶぅ
xjn	ぶぇ
xjs	ぶぉ
xjb	ぶぁん
xjm	ぶぃん
xjw	ぶぅん
xjv	ぶぇん
xjz	ぶぉん
xjf	ぶぁっ
xjg	ぶぃっ
xjc	ぶぅっ
xjr	ぶぇっ
xjl	ぶぉっ
y.d	ぷぁ
y.h	ぷぃ
y.t	ぷぅ
y.n	ぷぇ
y.s	ぷぉ
y.b	ぷぁん
y.m	ぷぃん
y.w	ぷぅん
y.v	ぷぇん
y.z	ぷぉん
y.f	ぷぁっ
y.g	ぷぃっ
y.c	ぷぅっ
y.r	ぷぇっ
y.l	ぷぉっ
p.d	むぁ
p.h	むぃ
p.t	むぅ
p.n	むぇ
p.s	むぉ
p.b	むぁん
p.m	むぃん
p.w	むぅん
p.v	むぇん
p.z	むぉん
p.f	むぁっ
p.g	むぃっ
p.c	むぅっ
p.r	むぇっ
p.l	むぉっ
..d	ゆぁ
..h	ゆぃ
..t	ゆぅ
..n	ゆぇ
..s	ゆぉ
..b	ゆぁん
..m	ゆぃん
..w	ゆぅん
..v	ゆぇん
..z	ゆぉん
..f	ゆぁっ
..g	ゆぃっ
..c	ゆぅっ
..r	ゆぇっ
..l	ゆぉっ
,.d	るぁ
,.h	るぃ
,.t	るぅ
,.n	るぇ
,.s	るぉ
,.b	るぁん
,.m	るぃん
,.w	るぅん
,.v	るぇん
,.z	るぉん
,.f	るぁっ
,.g	るぃっ
,.c	るぅっ
,.r	るぇっ
,.l	るぉっ
'.d	うぁ
'.h	うぃ
'.t	うぅ
'.n	うぇ
'.s	うぉ
'.b	うぁん
'.m	うぃん
'.w	うぅん
'.v	うぇん
'.z	うぉん
'.f	うぁっ
'.g	うぃっ
'.c	うぅっ
'.r	うぇっ
'.l	うぉっ
ueD	くあ
ueH	くい
ueT	くう
ueN	くえ
ueS	くお
ueB	くあん
ueM	くいん
ueW	くうん
ueV	くえん
ueZ	くおん
ueF	くあっ
ueG	くいっ
ueC	くうっ
ueR	くえっ
ueL	くおっ
kjD	ぐあ
kjH	ぐい
kjT	ぐう
kjN	ぐえ
kjS	ぐお
kjB	ぐあん
kjM	ぐいん
kjW	ぐうん
kjV	ぐえん
kjZ	ぐおん
kjF	ぐあっ
kjG	ぐいっ
kjC	ぐうっ
kjR	ぐえっ
kjL	ぐおっ
eeD	すあ
eeH	すい
eeT	すう
eeN	すえ
eeS	すお
eeB	すあん
eeM	すいん
eeW	すうん
eeV	すえん
eeZ	すおん
eeF	すあっ
eeG	すいっ
eeC	すうっ
eeR	すえっ
eeL	すおっ
jjD	ずあ
jjH	ずい
jjT	ずう
jjN	ずえ
jjS	ずお
jjB	ずあん
jjM	ずいん
jjW	ずうん
jjV	ずえん
jjZ	ずおん
jjF	ずあっ
jjG	ずいっ
jjC	ずうっ
jjR	ずえっ
jjL	ずおっ
oeD	つあ
oeH	つい
oeT	つう
oeN	つえ
oeS	つお
oeB	つあん
oeM	ついん
oeW	つうん
oeV	つえん
oeZ	つおん
oeF	つあっ
oeG	ついっ
oeC	つうっ
oeR	つえっ
oeL	つおっ
qjD	づあ
qjH	づい
qjT	づう
qjN	づえ
qjS	づお
qjB	づあん
qjM	づいん
qjW	づうん
qjV	づえん
qjZ	づおん
qjF	づあっ
qjG	づいっ
qjC	づうっ
qjR	づえっ
qjL	づおっ
aeD	ぬあ
aeH	ぬい
aeT	ぬう
aeN	ぬえ
aeS	ぬお
aeB	ぬあん
aeM	ぬいん
aeW	ぬうん
aeV	ぬえん
aeZ	ぬおん
aeF	ぬあっ
aeG	ぬいっ
aeC	ぬうっ
aeR	ぬえっ
aeL	ぬおっ
ieD	ふあ
ieH	ふい
ieT	ふう
ieN	ふえ
ieS	ふお
ieB	ふあん
ieM	ふいん
ieW	ふうん
ieV	ふえん
ieZ	ふおん
ieF	ふあっ
ieG	ふいっ
ieC	ふうっ
ieR	ふえっ
ieL	ふおっ
xjD	ぶあ
xjH	ぶい
xjT	ぶう
xjN	ぶえ
xjS	ぶお
xjB	ぶあん
xjM	ぶいん
xjW	ぶうん
xjV	ぶえん
xjZ	ぶおん
xjF	ぶあっ
xjG	ぶいっ
xjC	ぶうっ
xjR	ぶえっ
xjL	ぶおっ
y.D	ぷあ
y.H	ぷい
y.T	ぷう
y.N	ぷえ
y.S	ぷお
y.B	ぷあん
y.M	ぷいん
y.W	ぷうん
y.V	ぷえん
y.Z	ぷおん
y.F	ぷあっ
y.G	ぷいっ
y.C	ぷうっ
y.R	ぷえっ
y.L	ぷおっ
p.D	むあ
p.H	むい
p.T	むう
p.N	むえ
p.S	むお
p.B	むあん
p.M	むいん
p.W	むうん
p.V	むえん
p.Z	むおん
p.F	むあっ
p.G	むいっ
p.C	むうっ
p.R	むえっ
p.L	むおっ
..D	ゆあ
..H	ゆい
..T	ゆう
..N	ゆえ
..S	ゆお
..B	ゆあん
..M	ゆいん
..W	ゆうん
..V	ゆえん
..Z	ゆおん
..F	ゆあっ
..G	ゆいっ
..C	ゆうっ
..R	ゆえっ
..L	ゆおっ
,.D	るあ
,.H	るい
,.T	るう
,.N	るえ
,.S	るお
,.B	るあん
,.M	るいん
,.W	るうん
,.V	るえん
,.Z	るおん
,.F	るあっ
,.G	るいっ
,.C	るうっ
,.R	るえっ
,.L	るおっ
'.D	うあ
'.H	うい
'.T	うう
'.N	うえ
'.S	うお
'.B	うあん
'.M	ういん
'.W	ううん
'.V	うえん
'.Z	うおん
'.F	うあっ
'.G	ういっ
'.C	ううっ
'.R	うえっ
'.L	うおっ
uod	けぁ
uoh	けぃ
uot	けぅ
uon	けぇ
uos	けぉ
uob	けぁん
uom	けぃん
uow	けぅん
uov	けぇん
uoz	けぉん
uof	けぁっ
uog	けぃっ
uoc	けぅっ
uor	けぇっ
uol	けぉっ
kqd	げぁ
kqh	げぃ
kqt	げぅ
kqn	げぇ
kqs	げぉ
kqb	げぁん
kqm	げぃん
kqw	げぅん
kqv	げぇん
kqz	げぉん
kqf	げぁっ
kqg	げぃっ
kqc	げぅっ
kqr	げぇっ
kql	げぉっ
eod	せぁ
eoh	せぃ
eot	せぅ
eon	せぇ
eos	せぉ
eob	せぁん
eom	せぃん
eow	せぅん
eov	せぇん
eoz	せぉん
eof	せぁっ
eog	せぃっ
eoc	せぅっ
eor	せぇっ
eol	せぉっ
jqd	ぜぁ
jqh	ぜぃ
jqt	ぜぅ
jqn	ぜぇ
jqs	ぜぉ
jqb	ぜぁん
jqm	ぜぃん
jqw	ぜぅん
jqv	ぜぇん
jqz	ぜぉん
jqf	ぜぁっ
jqg	ぜぃっ
jqc	ぜぅっ
jqr	ぜぇっ
jql	ぜぉっ
ood	てぁ
ooh	てぃ
oot	てぅ
oon	てぇ
oos	てぉ
oob	てぁん
oom	てぃん
oow	てぅん
oov	てぇん
ooz	てぉん
oof	てぁっ
oog	てぃっ
ooc	てぅっ
oor	てぇっ
ool	てぉっ
qqd	でぁ
qqh	でぃ
qqt	でぅ
qqn	でぇ
qqs	でぉ
qqb	でぁん
qqm	でぃん
qqw	でぅん
qqv	でぇん
qqz	でぉん
qqf	でぁっ
qqg	でぃっ
qqc	でぅっ
qqr	でぇっ
qql	でぉっ
aod	ねぁ
aoh	ねぃ
aot	ねぅ
aon	ねぇ
aos	ねぉ
aob	ねぁん
aom	ねぃん
aow	ねぅん
aov	ねぇん
aoz	ねぉん
aof	ねぁっ
aog	ねぃっ
aoc	ねぅっ
aor	ねぇっ
aol	ねぉっ
iod	へぁ
ioh	へぃ
iot	へぅ
ion	へぇ
ios	へぉ
iob	へぁん
iom	へぃん
iow	へぅん
iov	へぇん
ioz	へぉん
iof	へぁっ
iog	へぃっ
ioc	へぅっ
ior	へぇっ
iol	へぉっ
xqd	べぁ
xqh	べぃ
xqt	べぅ
xqn	べぇ
xqs	べぉ
xqb	べぁん
xqm	べぃん
xqw	べぅん
xqv	べぇん
xqz	べぉん
xqf	べぁっ
xqg	べぃっ
xqc	べぅっ
xqr	べぇっ
xql	べぉっ
y,d	ぺぁ
y,h	ぺぃ
y,t	ぺぅ
y,n	ぺぇ
y,s	ぺぉ
y,b	ぺぁん
y,m	ぺぃん
y,w	ぺぅん
y,v	ぺぇん
y,z	ぺぉん
y,f	ぺぁっ
y,g	ぺぃっ
y,c	ぺぅっ
y,r	ぺぇっ
y,l	ぺぉっ
p,d	めぁ
p,h	めぃ
p,t	めぅ
p,n	めぇ
p,s	めぉ
p,b	めぁん
p,m	めぃん
p,w	めぅん
p,v	めぇん
p,z	めぉん
p,f	めぁっ
p,g	めぃっ
p,c	めぅっ
p,r	めぇっ
p,l	めぉっ
.,d	えぁ
.,h	えぃ
.,t	えぅ
.,n	えぇ
.,s	えぉ
.,b	えぁん
.,m	えぃん
.,w	えぅん
.,v	えぇん
.,z	えぉん
.,f	えぁっ
.,g	えぃっ
.,c	えぅっ
.,r	えぇっ
.,l	えぉっ
,,d	れぁ
,,h	れぃ
,,t	れぅ
,,n	れぇ
,,s	れぉ
,,b	れぁん
,,m	れぃん
,,w	れぅん
,,v	れぇん
,,z	れぉん
,,f	れぁっ
,,g	れぃっ
,,c	れぅっ
,,r	れぇっ
,,l	れぉっ
',d	ゑぁ
',h	ゑぃ
',t	ゑぅ
',n	ゑぇ
',s	ゑぉ
',b	ゑぁん
',m	ゑぃん
',w	ゑぅん
',v	ゑぇん
',z	ゑぉん
',f	ゑぁっ
',g	ゑぃっ
',c	ゑぅっ
',r	ゑぇっ
',l	ゑぉっ
uad	こあ
uah	こい
uat	こう
uan	こえ
uas	こお
uab	こあん
uam	こいん
uaw	こうん
uav	こえん
uaz	こおん
uaf	こあっ
uag	こいっ
uac	こうっ
uar	こえっ
ual	こおっ
k;d	ごあ
k;h	ごい
k;t	ごう
k;n	ごえ
k;s	ごお
k;b	ごあん
k;m	ごいん
k;w	ごうん
k;v	ごえん
k;z	ごおん
k;f	ごあっ
k;g	ごいっ
k;c	ごうっ
k;r	ごえっ
k;l	ごおっ
ead	そあ
eah	そい
eat	そう
ean	そえ
eas	そお
eab	そあん
eam	そいん
eaw	そうん
eav	そえん
eaz	そおん
eaf	そあっ
eag	そいっ
eac	そうっ
ear	そえっ
eal	そおっ
j;d	ぞあ
j;h	ぞい
j;t	ぞう
j;n	ぞえ
j;s	ぞお
j;b	ぞあん
j;m	ぞいん
j;w	ぞうん
j;v	ぞえん
j;z	ぞおん
j;f	ぞあっ
j;g	ぞいっ
j;c	ぞうっ
j;r	ぞえっ
j;l	ぞおっ
oad	とあ
oah	とい
oat	とう
oan	とえ
oas	とお
oab	とあん
oam	といん
oaw	とうん
oav	とえん
oaz	とおん
oaf	とあっ
oag	といっ
oac	とうっ
oar	とえっ
oal	とおっ
q;d	どあ
q;h	どい
q;t	どう
q;n	どえ
q;s	どお
q;b	どあん
q;m	どいん
q;w	どうん
q;v	どえん
q;z	どおん
q;f	どあっ
q;g	どいっ
q;c	どうっ
q;r	どえっ
q;l	どおっ
aad	のあ
aah	のい
aat	のう
aan	のえ
aas	のお
aab	のあん
aam	のいん
aaw	のうん
aav	のえん
aaz	のおん
aaf	のあっ
aag	のいっ
aac	のうっ
aar	のえっ
aal	のおっ
iad	ほあ
iah	ほい
iat	ほう
ian	ほえ
ias	ほお
iab	ほあん
iam	ほいん
iaw	ほうん
iav	ほえん
iaz	ほおん
iaf	ほあっ
iag	ほいっ
iac	ほうっ
iar	ほえっ
ial	ほおっ
x;d	ぼあ
x;h	ぼい
x;t	ぼう
x;n	ぼえ
x;s	ぼお
x;b	ぼあん
x;m	ぼいん
x;w	ぼうん
x;v	ぼえん
x;z	ぼおん
x;f	ぼあっ
x;g	ぼいっ
x;c	ぼうっ
x;r	ぼえっ
x;l	ぼおっ
y'd	ぽあ
y'h	ぽい
y't	ぽう
y'n	ぽえ
y's	ぽお
y'b	ぽあん
y'm	ぽいん
y'w	ぽうん
y'v	ぽえん
y'z	ぽおん
y'f	ぽあっ
y'g	ぽいっ
y'c	ぽうっ
y'r	ぽえっ
y'l	ぽおっ
p'd	もあ
p'h	もい
p't	もう
p'n	もえ
p's	もお
p'b	もあん
p'm	もいん
p'w	もうん
p'v	もえん
p'z	もおん
p'f	もあっ
p'g	もいっ
p'c	もうっ
p'r	もえっ
p'l	もおっ
.'d	よあ
.'h	よい
.'t	よう
.'n	よえ
.'s	よお
.'b	よあん
.'m	よいん
.'w	ようん
.'v	よえん
.'z	よおん
.'f	よあっ
.'g	よいっ
.'c	ようっ
.'r	よえっ
.'l	よおっ
,'d	ろあ
,'h	ろい
,'t	ろう
,'n	ろえ
,'s	ろお
,'b	ろあん
,'m	ろいん
,'w	ろうん
,'v	ろえん
,'z	ろおん
,'f	ろあっ
,'g	ろいっ
,'c	ろうっ
,'r	ろえっ
,'l	ろおっ
''d	をあ
''h	をい
''t	をう
''n	をえ
''s	をお
''b	をあん
''m	をいん
''w	をうん
''v	をえん
''z	をおん
''f	をあっ
''g	をいっ
''c	をうっ
''r	をえっ
''l	をおっ
uaD	こぁ
uaH	こぃ
uaT	こぅ
uaN	こぇ
uaS	こぉ
uaB	こぁん
uaM	こぃん
uaW	こぅん
uaV	こぇん
uaZ	こぉん
uaF	こぁっ
uaG	こぃっ
uaC	こぅっ
uaR	こぇっ
uaL	こぉっ
k;D	ごぁ
k;H	ごぃ
k;T	ごぅ
k;N	ごぇ
k;S	ごぉ
k;B	ごぁん
k;M	ごぃん
k;W	ごぅん
k;V	ごぇん
k;Z	ごぉん
k;F	ごぁっ
k;G	ごぃっ
k;C	ごぅっ
k;R	ごぇっ
k;L	ごぉっ
eaD	そぁ
eaH	そぃ
eaT	そぅ
eaN	そぇ
eaS	そぉ
eaB	そぁん
eaM	そぃん
eaW	そぅん
eaV	そぇん
eaZ	そぉん
eaF	そぁっ
eaG	そぃっ
eaC	そぅっ
eaR	そぇっ
eaL	そぉっ
j;D	ぞぁ
j;H	ぞぃ
j;T	ぞぅ
j;N	ぞぇ
j;S	ぞぉ
j;B	ぞぁん
j;M	ぞぃん
j;W	ぞぅん
j;V	ぞぇん
j;Z	ぞぉん
j;F	ぞぁっ
j;G	ぞぃっ
j;C	ぞぅっ
j;R	ぞぇっ
j;L	ぞぉっ
oaD	とぁ
oaH	とぃ
oaT	とぅ
oaN	とぇ
oaS	とぉ
oaB	とぁん
oaM	とぃん
oaW	とぅん
oaV	とぇん
oaZ	とぉん
oaF	とぁっ
oaG	とぃっ
oaC	とぅっ
oaR	とぇっ
oaL	とぉっ
q;D	どぁ
q;H	どぃ
q;T	どぅ
q;N	どぇ
q;S	どぉ
q;B	どぁん
q;M	どぃん
q;W	どぅん
q;V	どぇん
q;Z	どぉん
q;F	どぁっ
q;G	どぃっ
q;C	どぅっ
q;R	どぇっ
q;L	どぉっ
aaD	のぁ
aaH	のぃ
aaT	のぅ
aaN	のぇ
aaS	のぉ
aaB	のぁん
aaM	のぃん
aaW	のぅん
aaV	のぇん
aaZ	のぉん
aaF	のぁっ
aaG	のぃっ
aaC	のぅっ
aaR	のぇっ
aaL	のぉっ
iaD	ほぁ
iaH	ほぃ
iaT	ほぅ
iaN	ほぇ
iaS	ほぉ
iaB	ほぁん
iaM	ほぃん
iaW	ほぅん
iaV	ほぇん
iaZ	ほぉん
iaF	ほぁっ
iaG	ほぃっ
iaC	ほぅっ
iaR	ほぇっ
iaL	ほぉっ
x;D	ぼぁ
x;H	ぼぃ
x;T	ぼぅ
x;N	ぼぇ
x;S	ぼぉ
x;B	ぼぁん
x;M	ぼぃん
x;W	ぼぅん
x;V	ぼぇん
x;Z	ぼぉん
x;F	ぼぁっ
x;G	ぼぃっ
x;C	ぼぅっ
x;R	ぼぇっ
x;L	ぼぉっ
y'D	ぽぁ
y'H	ぽぃ
y'T	ぽぅ
y'N	ぽぇ
y'S	ぽぉ
y'B	ぽぁん
y'M	ぽぃん
y'W	ぽぅん
y'V	ぽぇん
y'Z	ぽぉん
y'F	ぽぁっ
y'G	ぽぃっ
y'C	ぽぅっ
y'R	ぽぇっ
y'L	ぽぉっ
p'D	もぁ
p'H	もぃ
p'T	もぅ
p'N	もぇ
p'S	もぉ
p'B	もぁん
p'M	もぃん
p'W	もぅん
p'V	もぇん
p'Z	もぉん
p'F	もぁっ
p'G	もぃっ
p'C	もぅっ
p'R	もぇっ
p'L	もぉっ
.'D	よぁ
.'H	よぃ
.'T	よぅ
.'N	よぇ
.'S	よぉ
.'B	よぁん
.'M	よぃん
.'W	よぅん
.'V	よぇん
.'Z	よぉん
.'F	よぁっ
.'G	よぃっ
.'C	よぅっ
.'R	よぇっ
.'L	よぉっ
,'D	ろぁ
,'H	ろぃ
,'T	ろぅ
,'N	ろぇ
,'S	ろぉ
,'B	ろぁん
,'M	ろぃん
,'W	ろぅん
,'V	ろぇん
,'Z	ろぉん
,'F	ろぁっ
,'G	ろぃっ
,'C	ろぅっ
,'R	ろぇっ
,'L	ろぉっ
''D	をぁ
''H	をぃ
''T	をぅ
''N	をぇ
''S	をぉ
''B	をぁん
''M	をぃん
''W	をぅん
''V	をぇん
''Z	をぉん
''F	をぁっ
''G	をぃっ
''C	をぅっ
''R	をぇっ
''L	をぉっ
Ood	てゃ
Ooh	てぃ
Oot	てゅ
Oon	てぇ
Oos	てょ
Oob	てゃん
Oom	てぃん
Oow	てゅん
Oov	てぇん
Ooz	てょん
Oof	てゃっ
Oog	てぃっ
Ooc	てゅっ
Oor	てぇっ
Ool	てょっ
Qqd	でゃ
Qqh	でぃ
Qqt	でゅ
Qqn	でぇ
Qqs	でょ
Qqb	でゃん
Qqm	でぃん
Qqw	でゅん
Qqv	でぇん
Qqz	でょん
Qqf	でゃっ
Qqg	でぃっ
Qqc	でゅっ
Qqr	でぇっ
Qql	でょっ
Ied	ふゃ
Ieh	ふぃ
Iet	ふゅ
Ien	ふぇ
Ies	ふょ
Ieb	ふゃん
Iem	ふぃん
Iew	ふゅん
Iev	ふぇん
Iez	ふょん
Ief	ふゃっ
Ieg	ふぃっ
Iec	ふゅっ
Ier	ふぇっ
Iel	ふょっ
Xjd	ぶゃ
Xjh	ぶぃ
Xjt	ぶゅ
Xjn	ぶぇ
Xjs	ぶょ
Xjb	ぶゃん
Xjm	ぶぃん
Xjw	ぶゅん
Xjv	ぶぇん
Xjz	ぶょん
Xjf	ぶゃっ
Xjg	ぶぃっ
Xjc	ぶゅっ
Xjr	ぶぇっ
Xjl	ぶょっ
Y.d	ぷゃ
Y.h	ぷぃ
Y.t	ぷゅ
Y.n	ぷぇ
Y.s	ぷょ
Y.b	ぷゃん
Y.m	ぷぃん
Y.w	ぷゅん
Y.v	ぷぇん
Y.z	ぷょん
Y.f	ぷゃっ
Y.g	ぷぃっ
Y.c	ぷゅっ
Y.r	ぷぇっ
Y.l	ぷょっ
;d	ぁ
;h	ぃ
;t	ぅ
;n	ぇ
;s	ぉ
;.d	ゃ
;.t	ゅ
;.s	ょ
;'d	ゎ
;ud	ゕ
;un	ゖ
;ot	っ
a	ん
a'	ん
.p	，
.,	．
-	ー
